2222222222
2010111012
2111111012
2110111112
2011110112
2011010112
2111110112
2101111012
2111101112
2222222222