2222222222
2010001012
2111101012
2110111112
2011110102
2011010102
2111110102
2101111012
2111100012
2222222222