2222222222
2001111112
2111111112
2110011112
2111111112
2110011112
2111111112
2111110012
2111111112
2222222222