1100111111
1111111111
1111111111
1110011111
1111111111
1110011111
1111111111
1111110011
1111111111
1111111111