2222222222
2000111112
2010111112
2010001112
2011110112
2000010112
2111110112
2111111012
2111101112
2222222222