1111111111
1011110111
0011100110
0210110110
1101122001
1220201022
1112201111
1110111012
1110100110
1110101011
