1111111111
1001010011
0011100110
0210110110
1101122001
1100201022
1110101111
1100110012
1110100110
1110101011
