2110111102
2101111102
2011111012
2111111102
2110111102
2010110112
2111111012
2110111102
2101101012
2111110112