1110111102
1111111112
1111111012
1111111112
1101111112
1111110112
1111111112
1111111102
1101111012
1111110112