0202000002
0101101010
0101010100
0101000000
0111000000
0111111112
0111111112
0111111112
0111111112
0000000000