2110111012
1110101010
1010101010
1011111101
1011111110
2111111112
0111111101
2101101112
0210110101
2100110111